# # # # # # # # # # # # # # # # # # # # # # # # # # # # # # # # # # # # # # # # # # # # # # # # # # # # # # # # # # # # # # # # # # # # # # # # # # # # # # # # # 
# # # # # # # # # # # # # # # # # # # # # # # # # # # # # # # # # # # # # # # # # # # # # # # # # # # # # # # # # # # # # # # # # # # # # # # # # # # # # # # # #
# # # # # # # # # # # # # #                                                           # # # # # # # # # # # # # # # # # # # # # # # # # # # # # # # # # # # # # #                                                                                                                                                                                                                             
# # # # # # # # # # # # # #                                                           # # # # # # # # # # # # # # # # # # # # # # # # # # # # # # # # # # # # # #                                                                      
I                                                                                     # # # # # # # # # # # # # # # # # # # # # # # # # # # # # # # # # # # # # #
I                                                                                     # # # # # # # # # # # # # # # # # # # # # # # # # # # # # # # # # # # # # # 
# # # # # # # # # #                                                                   # # # # # # # # # # # # # # # # # # # # # # # # # # # # # # # # # # # # # #      
# # # # # # # # # #                                                                   # # # # # # # # # # # # # # # # # # # # # # # # # # # # # # # # # # # # # #     
# # # # # # # # # #                                                                                         # # # # # # # # # # # # # # # # # # # # # # # # # # # 
# # # # # # # # # #                                                                                         # # # # # # # # # # # # # # # # # # # # # # # # # # #
# # # # # # # # # #                                                                                         # # # # # # # # # # # # # # # # # # # # # # # # # # #
# # # # # # # # # #                                                                                         # # # # # # # # # # # # # # # # # # # # # # # # # # #
# # # # # # # # # # # # # # # # # # # # #                                                                   # # # # # # # # # # # # # # # # # # # # # # # # # # #
# # # # # # # # # # # # # # # # # # # # #                                                                   # # # # # # # # # # # # # # # # # # # # # # # # # # #
# # # # # # # # # # # # # # # # # # # # #                                                                   # # # # # # # # # # # # # # # # # # # # # # # # # # #
# # # # # # # # # # # # # # # # # # # # #                                                                   # # # # # # # # # # # # # # # # # # # # # # # # # # #
# # # # # # # # # # # # # # # # # # # # #                                                                   # # # # # # # # # # # # # # # # # # # # # # # # # # #
# # # # # # # # # # # # # # # # # # # # #                                                                   # # # # # # # # # # # # # # # # # # # # # # # # # # #
# # # # # # # # # # # # # # # # # # # # #                                                                   # # # # # # # # # # # # # # # # # # # # # # # # # # #
# # # # # # # # # # # # # # # # # # # # #                                                                                 # # # # # # # # # # # # # # # # # # # #
# # # # # # # # # # # # # # # # # # # # # # # # # # # # # # # # # # # # #                                                 # # # # # # # # # # # # # # # # # # # #
# # # # # # # # # # # # # # # # # # # # # # # # # # # # # # # # # # # # #                                                 # # # # # # # # # # # # # # # # # # # #
# # # # # # # # # # # # # # # # # # # # # # # # # # # # # # # # # # # # #                                                 # # # # # # # # # # # # # # # # # # # #
# # # # # # # # # # # # # # # # # # # # # # # # # # # # # # # # # # # # #                                                 # # # # # # # # # # # # # # # # # # # #
# # #                                                                                                                     # # # # # # # # # # # # # # # # # # # #
# # #                                                                                                                     # # # # # # # # # # # # # # # # # # # #
# # #                                                         # # # # # # # # # # #                                       # # # # # # # # # # # # # # # # # # # #
# # #                                                         # # # # # # # # # # #                                       # # # # # # # # # # # # # # # # # # # #
# # # # # # # # # # # # # # # # # # # #                       # # # # # # # # # # #                                       # # # # # # # # # # # # # # # # # # # #
# # # # # # # # # # # # # # # # # # # #                       # # # # # # # # # # #                                       # # # # # # # # # # # # # # # # # # # #
# # # # # # # # # # # # # # # # # # # #                       # # # # # # # # # # #                                       # # # # # # # # # # # # # # # # # # # #                                                                                                                                                       
# # # # # # # # # # # # # # # # # # # #                       # # # # # # # # # # #                                       # # # # # # # # # # # # # # # # # # # #
# # # # # # # # # # # # # # # # # # # #                       # # # # # # # # # # #                                                                             E
# # # # # # # # # # # # # # # # # # # #                       # # # # # # # # # # #                                                                             E
# # # # # # # # # # # # # # # # # # # #                       # # # # # # # # # # # # # # # # # # # # # # # # # # # # # # # # # # # # # # # # # # # # # # # # # # 
# # # # # # # # # # # # # # # # # # # #                       # # # # # # # # # # # # # # # # # # # # # # # # # # # # # # # # # # # # # # # # # # # # # # # # # #     
# # # # # # # # # # # # # # # # # # # #                       # # # # # # # # # # # # # # # # # # # # # # # # # # # # # # # # # # # # # # # # # # # # # # # # # # 
# # # # # # # # # # # # # # # # # # # # # # # # # # # # # # # # # # # # # # # # # # # # # # # # # # # # # # # # # # # # # # # # # # # # # # # # # # # # # # # # #
# # # # # # # # # # # # # # # # # # # # # # # # # # # # # # # # # # # # # # # # # # # # # # # # # # # # # # # # # # # # # # # # # # # # # # # # # # # # # # # # #
# # # # # # # # # # # # # # # # # # # # # # # # # # # # # # # # # # # # # # # # # # # # # # # # # # # # # # # # # # # # # # # # # # # # # # # # # # # # # # # # #   